#.#############
#..........k.##
############.##
############.##
############.##
############.##
############.##
############.##
############.##
############.##
############.##
############.##
############.##
#############.#
#############.#
